R 800 600
F 78, 15,45
NO ./Selen_pp.xpm

SO ./Azur_pp.xpm

WE ./Allies_emblem.xpm

EA ./Ennemies_emblem.xpm

C 4, 134,225
S ./Selen_full.xpm

11111111111111111111111
10010010002000000000001
10000000000000000000001
10000020000000000201001
10000000000100000000001
100000N0000200000000001
10000000000000000000001
1111111111111111111111
